111111111111111111111111111111111111111111111111111111111111
110111101111011110111101111011110111101111011110111101111011
100000000000000000000000000000000000000000000000000000000001
110111101111011110111101111011110111101111011110111101111011
110111101111011110111101111011110111101111011110111101111011
110111101111011110111101111011110111101111011110111101111011
110111101111011110111101111011110111101111011110111101111011
100000000000000000000000000000000000000000000000000000000001
110111101111011110111101111011110111101111011110111101111011
110111101111011110111101111011110111101111011110111101111011
110111101111011110111101111011110111101111011110111101111011
110111101111011110111101111011110111101111011110111101111011
100000000000000000000000000000000000000000000000000000000001
110111101111011110111101111011110111101111011110111101111011
110111101111011110111101111011110111101111011110111101111011
110111101111011110111101111011110111101111011110111101111011
110111101111011110111101111011110111101111011110111101111011
100000000000000000000000000000000000000000000000000000000001
110111101111011110111101111011110111101111011110111101111011
110111101111011110111101111011110111101111011110111101111011
110111101111011110111101111011110111101111011110111101111011
110111101111011110111101111011110111101111011110111101111011
100000000000000000000000000000000000000000000000000000000001
110111101111011110111101111011110111101111011110111101111011
110111101111011110111101111011110111101111011110111101111011
110111101111011110111101111011110111101111011110111101111011
110111101111011110111101111011110111101111011110111101111011
100000000000000000000000000000000000000000000000000000000001
110111101111011110111101111011110111101111011110111101111011
110111101111011110111101111011110111101111011110111101111011
110111101111011110111101111011110111101111011110111101111011
110111101111011110111101111011110111101111011110111101111011
100000000000000000000000000000000000000000000000000000000001
110111101111011110111101111011110111101111011110111101111011
110111101111011110111101111011110111101111011110111101111011
110111101111011110111101111011110111101111011110111101111011
110111101111011110111101111011110111101111011110111101111011
100000000000000000000000000000000000000000000000000000000001
110111101111011110111101111011110111101111011110111101111011
110111101111011110111101111011110111101111011110111101111011
110111101111011110111101111011110111101111011110111101111011
110111101111011110111101111011110111101111011110111101111011
100000000000000000000000000000000000000000000000000000000001
110111101111011110111101111011110111101111011110111101111011
110111101111011110111101111011110111101111011110111101111011
110111101111011110111101111011110111101111011110111101111011
110111101111011110111101111011110111101111011110111101111011
100000000000000000000000000000000000000000000000000000000001
110111101111011110111101111011110111101111011110111101111011
110111101111011110111101111011110111101111011110111101111011
110111101111011110111101111011110111101111011110111101111011
110111101111011110111101111011110111101111011110111101111011
100000000000000000000000000000000000000000000000000000000001
110111101111011110111101111011110111101111011110111101111011
110111101111011110111101111011110111101111011110111101111011
110111101111011110111101111011110111101111011110111101111011
110111101111011110111101111011110111101111011110111101111011
100000000000000000000000000000000000000000000000000000000001
110111101111011110111101111011110111101111011110111101111011
111111111111111111111111111111111111111111111111111111111111