000000000000000000000000000000000000000000000000000000000000
010000010000100000100001000010000001001001001001000100001000
010000010000100000100001000010000001111111111111111111111110
011111111111111111111111111110000001001001001001000100001000
010000010000100000100001000010000001111111111111111111111110
010000010000100000100001000010000001001001001001000100001000
011111111111111111111111111111111111111111111111111111111110
010000010000100000100001000010000001001001001001000100001000
011111111111111111111111111111111111111111111111111111111110
010000010000100000100001000010000001001001001001000100001000
011111111111111111111111111111111111111111111111111111111110
010000110000100000100001000010000001001001001001000100001000
011111111111111111111111111111111111111111111111111111111110
010001010000100000100001000010000001001001001001000100001000
011111111111111111111111111111111111111111111111111111111110
010001010000100000100001000010000001001001001001000100001000
010001010000100000100001000010000001111111111111111100001000
011111111111111111111111111110000001001001001001000100001000
010000010000100000100001000010000001001001001001000100001000
011111111111111111111111111111111111111111111111111111111110
010000010000100000100001000010000001001001001001000100001000
011111111111100000100001000010000001001001001001000100001000
010000010000111111111111111111111111111111111111111111111110
011111111111100000100001000010000001001001001001000100001000
010000010000100000100001000010000001001001001001000100001000
011111111111111111111111111111111111111111111111111111111110
010000010000100000100001000010000001001001001001000100001000
011111111111111111111111111111111111111111111111111111111000
010000010000100000100001000010000001001001001001000100001000
010000010000100000100001000010000001001001001001000111111000
011111111111111111111111111111111111111111111111111100001000
010000010000100000100001000010000001001001001001000100001000
011111111111111111111111111111111111111111111111111100001000
010000010000100000100001000010000001001001001001000111111110
011111111111111111111111111111111111111111111111000100001000
010000010000100000100001000010000001001001001001000111111110
011111111111111111111111111111111111111111111111111100001000
010000010000100000100001000010000001001001001001000100001000
011111111111100000111111111111111111111111111111111111111110
010000010000100000100001000010000001001001001001000100001000
011111111111111111111111111111111111111111111111111111111110
010000010000100000100001000010000001001001001001000100001000
010000010000100000100001000010000001001001001001000100001000
011111111111111111111111111111111111111111111111111111111110
010000010000100000100001000010000001000001000001000100001000
011111111111111111111111111111111111111111111111111111111110
000000010000100000100001000010000001000001000001000100001000
001111111111111111111111111111111111111111111111111111111110
000000010000100000100001000010000001000001000001000100101000
000111111111111111111111111111111111111111111111111111111110
000000010000100000100001000010000001000001000001000100001000
000011111111111111111111111111111111111111111111111111111110
000000010000100000100001000010000001000001000001000100001000
000011111111111111111111111111111111111111111111111100001000
000000010000100000100001000010000001000001000001001100001000
000000111111111111111111111111111111111001111111111100001000
000000010000100000100001000010000001000001000001000100001000
000000111111111111111111111111111111111111111111111111111110
000000000000000000100001000010000001000000000001000100001000
000000000000000000000000000000000000000000000000000000000000